nnnnnnnnnnbnnnnnnnnnnnnnnnnnnnnnnnnnnnnnnnnnnnnnnnnnnnnnnnnnnnnnnnnnnnnnnnnnnnnn
..............................................nn.......nn.......................
...................n............................................................
...................no.....................n.........n.......n...................
........nnnnnnn.nnnnnnnnnnnn.........3##########################.......nnnnnnnnn
......n.......n.n...........nn....................dd3...........................
.....n........n.n.............nn..................dd............................
....n.........nin...............nn................dd............................
...n..........n.n.................nn.............3dd............................
nnnn..........n.n...................nnnnnnnnnnnnnnnnnnnnnnnnnaaaaaaaaaaaaaaaaaaa