nnnnnnnnnaaaaaaaaaannnnnnnnnn
........4.........n..........
........4.........4..........
.............................
.............................
.............................
.............................
........41#########4.........
........n..........4.........
aaaaaaaannnnnnnnnnnaaaaaaaaaa
