nnnnnnnn...nnnnnnnnnnnnnnnnnn
.......n...n......mmm........
.......n...n.................
.......n...n.................
.......n...n3#...............
.................n...n.......
.................n...n.......
...4###..........n...n.......
.................n...n.......
nnnnnnnnnnnnnnnnnn...nnnnnnnn