nnnnnnnnnnnnnnnnnnnnnnnnnnnnn
......d..............n.......
......d..............n.......
......d..............n.......
......d..............d.......
......d..............d.......
......n..............d.......
......n..............d.......
......n..............n.......
nnnnnnnnnnnnnnnnnnnnnnnnnnnnn
