nnnnnnnnnnnnnnnnnnnnnnnnnnnnn
...n.....n....n....n....n....
...................4#####1111
.......2.....................
3......4###..................
.2.........2..........1......
.....1.....4##...........3###
....1........................
...n.....n....n....n....n22..
nnnnnnnnnnnnnnnnnnnnnnnnnnnnn
