nnnnnnnn....nnnnnnnnnnnnnnnnn
.......n................n....
.......n................n....
.......n................n....
......in................n....
nnnnnnnn.......n.............
...............n.............
...............n.............
......o........n.............
nnnnnnnnnnnnnnnnnnnnnnnnnnnnn
