nnn.......................nnn
..n....................nnn...
..nnn...............nnn......
.....nnn.........nnn.........
........nnnnnnnnn............
..........................nnn
.......................nnn...
..nnn...............nnn......
..n..nnn.........nnn.........
nnn.....nnnnnnnnn............
