nnnnnnnnnnnnnnnnnn
....d.............
....d.............
....d...6#######..
..................
..................
....3####.........
..................
...........2..2...
nnnnnnnnnnnnnnnnnn
